50
85
49
60
1
# items
p 0 45 55
# topology
0000000000000000000000000000000000000000000007777777777777777777777777777777777777777
0000000000000000000000000000000000000000000007777777777777777777777777777777777777777
0000000000000000000000000000000000000000000007777777777777777779999977777777777777777
0000000000000000000000000000000000000000000007777777777777777779999977777777777777777
0000000000000000000000000000000000000000000007777777777777777779999977777777777777777
0000000000000000000000000000000000000000000007777777777777777779999977777777777777777
0000000000000000000000000000000000000000000007777777777777777779999977777777777777777
0000000000000000000000000000000000000000000007777777777777777777777777777777777777777
0000000000000000000000000000000000000000000007777777777777777777777777777777777777777
0000000000000000000000000000000000000000000007777777777777777777777777777777777777777
0000000000000000000000000000000000000000000007777777777777777777777777777777777777777
0000000000000000000000011111111111111111000007777777777788877777777777788877777777777
0000000000000000000000022222222222222222000007777777777788877777777777788877777777777
0000000000000000000000033333333333333333000007777777777788877777777777788877777777777
0000000000000000000000044444444444444444000007777777777777777777777777777777777777777
0000000000000000000000055555555555555555000007777777777777777777777777777777777777777
0000000000000000000000066666666666666666000007777777777777777777777777777777777777777
0000000000000000000000077777777777777777000007777777777777777777777777777777777777777
0000000000000000000000088888888888888888000007777777777777777777777777777777777777777
0000000000000000000000088888888888888888000007778887777788877777999777788877777888777
0000000000000000000000088888888888888888000007778887777788877777999777788877777888777
0000000000000000000000077777777777777777000007778887777788877777999777788877777888777
0000000000000000000000066666666666666666000007777777777777777777888777777777777777777
0000000000000000000000055555555555555555000007777777777777777777888777777777777777777
0000000000000000000000044444444444444444000007777777777777777777777777777777777777777
0000000000000000000000033333333333333333000007777777777777777777777777777777777777777
0000000000000000000000022222222222222222000006666666666666677777777777776666666666666
0000000000000000000000011111111111111111000006666666666666667777777777766666666666666
0000000000000000000000000000000000000000000003333333333333333777777777333333333333333
0000000000000000000000000000000000000000000001111122211111111177777771111111122211111
0000000000000000000000000000000000000000000000000000000000000007777700000000000000000
0000000000000000000000000000000000000000000000000000000000000000777000000000000000000
0000000000000000000000000000000000000000000000000000000000000000000000000000000000000
0000000000000000000000000000000000000000000000000000000000000000000000000000000000000
0000000000000000000000000000000000000000000000000000000000000000000000000000000000000
0000000000000000000000000000000000000000000000000000000000000000000000000000000000000
0000000000000000000000000000000000000000000000000000000000000000000000000000000000000
0000000000000000000000000000000000000000000000000000000000000000000000000000000000000
0000000000000000000000000000000000000000000000000000000000000000000000000000000000000
0000000000000000000000000000000000000000000000000000000000000000000000000000000000000
0000000000000000000000000000000000000000000000000000000000000000000000000000000000000
0000000000000000000000000000000000000000000000000000000000000000000000000000000000000
0000000000000000000000000000000000000000000000000000000000000000000000000000000000000
0000000000000000000000000000000000000000000000000000000000000000000000000000000000000
0000000000000000000000000000000000000000000000000000000000000000000000000000000000000
0000000000000000000000000000000000000000000000000000000000000000000000000000000000000
0000000000000000000000000000000000000000000000000000000000000000000000000000000000000
0000000000000000000000000000000000000000000000000000000000000000000000000000000000000
0000000000000000000000000000000000000000000000000000000000000000000000000000000000000
0000000000000000000000000000000000000000000000000000000000000000000000000000000000000
# terrain
.............................................ssssssssssssssssssssssssssssssssssssssss
.............................................ssssssssssssssssssssssssssssssssssssssss
.............................................ssssssssssssssssssssssssssssssssssssssss
.............................................ssssssssssssssssssssssssssssssssssssssss
.............................................ssssssssssssssssssssssssssssssssssssssss
.............................................ssssssssssssssssssssssssssssssssssssssss
.............................................ssssssssssssssssssssssssssssssssssssssss
.............................................ssssssssssssssssssssssssssssssssssssssss
.............................................ssssssssssssssssssssssssssssssssssssssss
.............................................ssssssssssssssssssssssssssssssssssssssss
.............................................ssssssssssssssssssssssssssssssssssssssss
.......................ggggggggggggggggg.....ssssssssssssssssssssssssssssssssssssssss
.......................ggggggggggggggggg.....ssssssssssssCssssssssssssssCssssssssssss
.......................ggggggggggggggggg.....ssssssssssssssssssssssssssssssssssssssss
.......................ggggggggggggggggg.....ssssssssssssssssssssssssssssssssssssssss
.......................ggggggggggggggggg.....ssssssssssssssssssssssssssssssssssssssss
.......................ggggggggggggggggg.....ssssssssssssssssssssssssssssssssssssssss
.......................ggggggggggggggggg.....ssssssssssssssssssssssssssssssssssssssss
.......................ggggggggggggggggg.....ssssssssssssssssssssssssssssssssssssssss
.......................ggggggggggggggggg.....ssssssssssssssssssssssssssssssssssssssss
.......................ggggggggggggggggg.....ssssssssssssCssssssspssssssCssssssssssss
.......................ggggggggggggggggg.....ssssssssssssssssssssssssssssssssssssssss
.......................ggggggggggggggggg.....ssssssssssssssssssssssssssssssssssssssss
.......................ggggggggggggggggg.....ssssssssssssssssssssssssssssssssssssssss
.......................ggggggggggggggggg.....ssssssssssssssssssssssssssssssssssssssss
.......................ggggggggggggggggg.....ssssssssssssssssssssssssssssssssssssssss
.......................ggggggggggggggggg.....ssssssssssssssssssssssssssssssssssssssss
.......................ggggggggggggggggg.....ssssssssssssssssssssssssssssssssssssssss
.............................................ssssssssssssssssssssssssssssssssssssssss
.............................................ssssssssssssssssssssssssssssssssssssssss
.....................................................................................
.....................................................................................
.....................................................................................
.....................................................................................
.....................................................................................
.....................................................................................
.....................................................................................
.....................................................................................
.....................................................................................
.....................................................................................
.....................................................................................
.....................................................................................
.....................................................................................
.....................................................................................
.....................................................................................
.....................................................................................
.....................................................................................
.....................................................................................
.....................................................................................
.....................................................................................
