50
85
# topology
7777777777777777777777777777777777777777000007777777777777777777777777777777777777777
7777777777777777777777777777777777777777000007777777777777777777777777777777777777777
7777777777777777779999977777777777777777000007777777777777777779999977777777777777777
7777777777777777779999977777777777777777000007777777777777777779999977777777777777777
7777777777777777779999977777777777777777000007777777777777777779999977777777777777777
7777777777777777779999977777777777777777000007777777777777777779999977777777777777777
7777777777777777779999977777777777777777000007777777777777777779999977777777777777777
7777777777777777777777777777777777777777000007777777777777777777777777777777777777777
7777777777777777777777777777777777777777000007777777777777777777777777777777777777777
7777777777777777777777777777777777777777000007777777777777777777777777777777777777777
7777777777777777777777777777777777777777000007777777777777777777777777777777777777777
7777777777788877777777777788877777777777000007777777777788877777777777788877777777777
7777777777788877777777777788877777777777000007777777777788877777777777788877777777777
7777777777788877777777777788877777777777000007777777777788877777777777788877777777777
7777777777777777777777777777777777777777000007777777777777777777777777777777777777777
7777777777777777777777777777777777777777000007777777777777777777777777777777777777777
7777777777777777777777777777777777777777000007777777777777777777777777777777777777777
7777777777777777777777777777777777777777000007777777777777777777777777777777777777777
7777777777777777777777777777777777777777000007777777777777777777777777777777777777777
7778887777788877777999777788877777888777000007778887777788877777999777788877777888777
7778887777788877777999777788877777888777000007778887777788877777999777788877777888777
7778887777788877777999777788877777888777000007778887777788877777999777788877777888777
7777777777777777777888777777777777777777000007777777777777777777888777777777777777777
7777777777777777777888777777777777777777000007777777777777777777888777777777777777777
7777777777777777777777777777777777777777000007777777777777777777777777777777777777777
7777777777777777777777777777777777777777000007777777777777777777777777777777777777777
6666666666666677777777777776666666666666000006666666666666677777777777776666666666666
6666666666666667777777777766666666666666000006666666666666667777777777766666666666666
3333333333333333777777777333333333333333000003333333333333333777777777333333333333333
1111122211111111177777771111111122211111000001111122211111111177777771111111122211111
0000000000000000007777700000000000000000000000000000000000000007777700000000000000000
0000000000000000000777000000000000000000000000000000000000000000777000000000000000000
0000000000000000000000000000000000000000000000000000000000000000000000000000000000000
0000000000000000000000000000000000000000000000000000000000000000000000000000000000000
0000000000000000009999990000000000000000000000000000000000000000000000000000000000000
0000000000000000009999990000000000000000000000000000000000000000000000000000000000000
0000000000001234567898765432100000000000000000000000000000000000000000000000000000000
0000000000001234567898765432100000000000000000000000000000000000000000000000000000000
0000000000001234567898765432100000000000000000000000000000000000000000000000000000000
0000000000001234567898765432100000000000000000000000000000000000000000000000000000000
0000000000000000000000000000000000000000000000000000000000000000000000000000000000000
0000000000000000000000000000000000000000000000000000000000000000000000000000000000000
0000000000000000000000000000000000000000000000000000000000000000000000000000000000000
0000000000000000000000000000000000000000000000000000000000000000000000000000000000000
0000000000000000000000000000000000000000000000000000000000000000000000000000000000000
0000000000000000000000000000000000000000000000000000000000000000000000000000000000000
0000000000000000000000000000000000000000000000000000000000000000000000000000000000000
0000000000000000000000000000000000000000000000000000000000000000000000000000000000000
0000000000000000000000000000000000000000000000000000000000000000000000000000000000000
0000000000000000000000000000000000000000000000000000000000000000000000000000000000000
# terrain
ssssssssssssssssssssssssssssssssssssssss.....ssssssssssssssssssssssssssssssssssssssss
sggggggggggggggggggggggggggggggggggggggs.....sggggggggggggggggggggggggggggggggggggggs
sgggggggggggggggggcccccggggggggggggggggs.....sgggggggggggggggggcccccggggggggggggggggs
sgggggggggggggggggcccccggggggggggggggggs.....sgggggggggggggggggcccccggggggggggggggggs
sgggggggggggggggggcccccggggggggggggggggs.....sgggggggggggggggggcccccggggggggggggggggs
sgggggggggggggggggcccccggggggggggggggggs.....sgggggggggggggggggcccccggggggggggggggggs
sgggggggggggggggggcccccggggggggggggggggs.....sgggggggggggggggggcccccggggggggggggggggs
sggggggggggggggggggggggggggggggggggggggs.....sggggggggggggggggggggggggggggggggggggggs
sggggggggggggggggggggggggggggggggggggggs.....sggggggggggggggggggggggggggggggggggggggs
sggggggggggggggggggggggggggggggggggggggs.....sggggggggggggggggggggggggggggggggggggggs
sggggggggggggggggggggggggggggggggggggggs.....sggggggggggggggggggggggggggggggggggggggs
sggggggggggcccggggggggggggcccggggggggggs.....sggggggggggcccggggggggggggcccggggggggggs
sggggggggggcccggggggggggggcccggggggggggs.....sggggggggggcccggggggggggggcccggggggggggs
sggggggggggcccggggggggggggcccggggggggggs.....sggggggggggcccggggggggggggcccggggggggggs
sggggggggggggggggggggggggggggggggggggggs.....sggggggggggggggggggggggggggggggggggggggs
sggggggggggggggggggggggggggggggggggggggs.....sggggggggggggggggggggggggggggggggggggggs
sggggggggggggggggggggggggggggggggggggggs.....sggggggggggggggggggggggggggggggggggggggs
sggggggggggggggggggggggggggggggggggggggs.....sggggggggggggggggggggggggggggggggggggggs
sggggggggggggggggggggggggggggggggggggggs.....sggggggggggggggggggggggggggggggggggggggs
sggcccgggggcccgggggcccggggcccgggggcccggs.....sggcccgggggcccgggggcccggggcccgggggcccggs
sggcccgggggcccgggggcccggggcccgggggcccggs.....sggcccgggggcccgggggcccggggcccgggggcccggs
sggcccgggggcccgggggcccggggcccgggggcccggs.....sggcccgggggcccgggggcccggggcccgggggcccggs
sggggggggggggggggggcccgggggggggggggggggs.....sggggggggggggggggggcccgggggggggggggggggs
sggggggggggggggggggcccgggggggggggggggggs.....sggggggggggggggggggcccgggggggggggggggggs
sggggggggggggggggggggggggggggggggggggggs.....sggggggggggggggggggggggggggggggggggggggs
sggggggggggggggggggggggggggggggggggggggs.....sggggggggggggggggggggggggggggggggggggggs
ssssssssssssssssssssssssssssssssssssssss.....ssssssssssssssssssssssssssssssssssssssss
ssssssssssssssssssssssssssssssssssssssss.....ssssssssssssssssssssssssssssssssssssssss
ssssssssssssssssssssssssssssssssssssssss.....ssssssssssssssssssssssssssssssssssssssss
ssssssssssssssssssssssssssssssssssssssss.....ssssssssssssssssssssssssssssssssssssssss
.....................................................................................
.....................................................................................
.....................................................................................
.....................................................................................
....................ssss.............................................................
....................ssss.............................................................
............sssssssssssssssssss......................................................
............sssssssssssssssssss......................................................
............sssssssssssssssssss......................................................
............sssssssssssssssssss......................................................
.........................................*...........................................
.....................................................................................
.....................................................................................
.....................................................................................
.....................................................................................
.....................................................................................
.....................................................................................
.....................................................................................
.....................................................................................
.....................................................................................
