30
40
# topology
0000000000000000000000000000000000000000
8888899988888880000000000000000000000000
7777777777777770000000000000000000000000
7777777777777770000000000000000000000000
7777777777777770000000000000000000000000
7777777777777770000000000000000000000000
6666677777666660000000000000000000000000
6666677777666660000000000000000000000000
3333377777333330099999900000000000000000
1111177777111110000000000000000000000000
0000077777000000000099900000000000000000
0000000000000000000000000000000000000000
0000000000000000000099900000000000000000
0000000000000000000000000000000000000000
0000000000000000000099900000000000000000
0000000000000000000000000000000000000000
0000000000001234567899900000000000000000
0000000000000000000000000000000000000000
0000000000000000000000000000000000000000
0000000000000000000000000000000000000000
0000000000000000000000000000000000000000
0000000000000000000000000000000000000000
0000000000000000000000000000000000000000
0000000000000000000000000000000000000000
0000000000000000000000000000000000000000
0000000000000000000000000000000000000000
0000000000000000000000000000000000000000
0000000000000000000000000000000000000000
0000000000000000000000000000000000000000
0000000000000000000000000000000000000000
# terrain
........................................
ccccccccccccccc.........................
ccccccccccccccc.........................
ccccccccccccccc.........................
ccccccccccccccc.........................
ccccccccccccccc.........................
ccccccccccccccc.........................
ccccccccccccccc.........................
ccccccccccccccc..cccccc.................
ccccccccccccccc.........................
....................ccc.................
........................................
....................ccc.................
........................................
....................ccc.................
........................................
............ccccccccccc.................
........................................
........................................
........................................
........................................
........................................
........................................
........................................
........................................
........................................
........................................
........................................
........................................
s.......................................
