30
40
24
20
2
# item
f 1 21 3
s 1 3 36
# topology
1111111111111111111111111111111111111111
4444444400000000444444440000000044444444
4444444400000000444444440000000044444444
4444444400000000444444440000000044444444
4444444400000000444444440000000044444444
1004400000000000000440000000000000044001
1000000000000000000000000000000000000001
1111111111111111111111111111111111111111
1000000000000000000000000000000000000001
4444444400000000444444440000000044444444
4444444400000000444444440000000044444444
4444444400000000444444440000000044444444
4444444400000000444444440000000044444444
4444444400000000444444440000000044444444
1004400000000000000440000000000000044001
1000000000000000000000000000000000000001
1111111111111111111111111111111111111111
1000000000000000000000000000000000000001
4444444400000000444444440000000044444444
4444444400000000444444440000000044444444
4444444400000000444444440000000044444444
4444444400000000444444440000000044444444
4444444400000000444444440000000044444444
0004400000000000000440000000000000044000
0000000000000000000000000000000000000000
0000000000000000000000000000000000000000
0000000000000000000000000000000000000000
0000000000000000000000000000000000000000
0000000000000000000000000000000000000000
0000000000000000000220000000000000000000
# terrain
ffffffffffffffffffffffffffffffffffffffff
ssssssss...CC...ssssssss...CC...ssssssss
ssssssss...CC...ssssssss...CC...ssssssss
ssssssss........ssssssss........ssssssss
ssssssss........ssssssss........ssssssss
f......................................f
f......................................f
ffffffffffffffffffffffffffffffffffffffff
f......................................f
ssssssss........ssssssss........ssssssss
ssssssss........ssssssss........ssssssss
ssssssss........ssssssss........ssssssss
ssssssss........ssssssss........ssssssss
ssssssss........ssssssss........ssssssss
f......................................f
f......................................f
ffffffffffffffffffffffffffffffffffffffff
f......................................f
ssssssss........ssssssss........ssssssss
ssssssss........ssssssss........ssssssss
ssssssss........ssssssss........ssssssss
ssssssss........ssssssss........ssssssss
ssssssss........ssssssss........ssssssss
........................................
........................................
........................................
........................................
........................................
........................................
...................pp...................


