50
40
# topology
7777777777777777777777777777777777777777
7777777777777777777777777777777777777777
7777777777777777779999977777777777777777
7777777777777777779999977777777777777777
7777777777777777779999977777777777777777
7777777777777777779999977777777777777777
7777777777777777779999977777777777777777
7777777777777777777777777777777777777777
7777777777777777777777777777777777777777
7777777777777777777777777777777777777777
7777777777777777777777777777777777777777
7777777777788877777777777788877777777777
7777777777788877777777777788877777777777
7777777777788877777777777788877777777777
7777777777777777777777777777777777777777
7777777777777777777777777777777777777777
7777777777777777777777777777777777777777
7777777777777777777777777777777777777777
7777777777777777777777777777777777777777
7778887777788877777999777788877777888777
7778887777788877777999777788877777888777
7778887777788877777999777788877777888777
7777777777777777777777777777777777777777
7777777777777777777777777777777777777777
7777777777777777777888777777777777777777
7777777777777777777777777777777777777777
6666666666666677777777777776666666666666
6666666666666667777777777766666666666666
3333333333333333777777777333333333333333
1111122211111111177777771111111122211111
0000000000000000007777700000000000000000
0000000000000000000777000000000000000000
0000000000000000000000000000000000000000
0000000000000000000000000000000000000000
0000000000000000009999990000000000000000
0000000000000000009999990000000000000000
0000000000001234567898765432100000000000
0000000000001234567898765432100000000000
0000000000001234567898765432100000000000
0000000000001234567898765432100000000000
0000000000000000000000000000000000000000
0000000000000000000000000000000000000000
0000000000000000000000000000000000000000
0000000000000000000000000000000000000000
0000000000000000000000000000000000000000
0000000000000000000000000000000000000000
0000000000000000000000000000000000000000
0000000000000000000000000000000000000000
0000000000000000000000000000000000000000
0000000000000000000000000000000000000000
# terrain
cccccccccccccccccccccccccccccccccccccccc
cccccccccccccccccccccccccccccccccccccccc
cccccccccccccccccccccccccccccccccccccccc
cccccccccccccccccccccccccccccccccccccccc
cccccccccccccccccccccccccccccccccccccccc
cccccccccccccccccccccccccccccccccccccccc
cccccccccccccccccccccccccccccccccccccccc
cccccccccccccccccccccccccccccccccccccccc
cccccccccccccccccccccccccccccccccccccccc
cccccccccccccccccccccccccccccccccccccccc
cccccccccccccccccccccccccccccccccccccccc
cccccccccccccccccccccccccccccccccccccccc
cccccccccccccccccccccccccccccccccccccccc
cccccccccccccccccccccccccccccccccccccccc
cccccccccccccccccccccccccccccccccccccccc
cccccccccccccccccccccccccccccccccccccccc
cccccccccccccccccccccccccccccccccccccccc
cccccccccccccccccccccccccccccccccccccccc
cccccccccccccccccccccccccccccccccccccccc
cccccccccccccccccccccccccccccccccccccccc
cccccccccccccccccccccccccccccccccccccccc
cccccccccccccccccccccccccccccccccccccccc
cccccccccccccccccccccccccccccccccccccccc
cccccccccccccccccccccccccccccccccccccccc
cccccccccccccccccccccccccccccccccccccccc
cccccccccccccccccccccccccccccccccccccccc
cccccccccccccccccccccccccccccccccccccccc
cccccccccccccccccccccccccccccccccccccccc
cccccccccccccccccccccccccccccccccccccccc
cccccccccccccccccccccccccccccccccccccccc
........................................
........................................
........................................
........................................
...................ccccc................
...................ccccc................
............ccccccccccccccccccc.........
............ccccccccccccccccccc.........
............ccccccccccccccccccc.........
............ccccccccccccccccccc.........
........................................
........................................
........................................
........................................
........................................
........................................
........................................
........................................
........................................
s.......................................
